13  9  11  10  11  11  12  13  13  13  13  13  13  13  13  13  13  13  13  13  13  13  13  13  13  13  13  13  13  13  13  13  13  13  13  13  13  13  13  13  13  13  13
13  9  11  10  11  11  12  13  13  13  13  13  13  13  13  13  13  13  13  13  13  13  13  13  13  13  13  13  13  13  13  13  13  13  13  13  13  13  13  13  13  13  13
13  9  11  10  11  11  12  13  13  13  13  13  13  13  13  13  13  13  13  13  13  13  13  13  13  13  13  13  13  13  13  13  13  13  13  13  13  13  13  13  13  13  13
13  9  11  10  11  11  12  13  13  13  13  13  13  13  13  13  13  13  13  13  13  13  13  13  13  13  13  13  13  13  13  13  13  13  13  13  13  13  13  13  13  13  13
13  9  11  10  11  11  12  13  13  13  13  13  13  13  13  13  13  13  13  13  13  13  13  13  13  13  13  13  13  13  13  13  13  13  13  13  13  13  13  13  13  13  13
13  9  11  10  11  11  12  13  13  13  13  13  13  13  13  40  41  41  41  41  41  41  41  41  42  13  13  13  13  13  13  13  13  13  13  13  13  13  13  13  13  13  13
13  9  11  10  11  11  12  13  13  13  13  13  13  13  13  39  168  167  166  165  164  164  163  162  43  13  13  13  13  13  13  13  13  13  13  13  13  13  13  13  13  13  13
13  9  11  10  11  11  12  13  13  13  25  26  27  28  29  38  169  170  171  172  173  173  174  161  44  13  13  13  13  13  13  13  13  13  13  13  13  13  13  13  13  13  13
13  9  11  10  11  11  12  13  13  13  24  85  86  87  30  37  181  180  179  178  177  176  175  160  44  13  13  13  13  13  13  13  13  13  13  13  13  13  13  13  13  13  13
13  9  11  10  11  11  12  13  13  13  23  84  91  88  31  36  182  183  184  185  144  157  158  159  44  13  13  13  13  13  13  13  13  13  13  13  13  13  13  13  13  13  13
13  9  11  10  14  15  12  13  13  13  22  83  90  89  32  35  144  144  144  144  144  156  155  154  44  13  13  13  13  13  13  13  13  13  13  13  13  13  13  13  13  13  13
13  9  11  10  17  16  12  13  13  13  22  79  80  75  33  34  144  144  144  144  144  151  152  153  44  13  13  13  13  13  13  13  13  13  13  13  13  13  13  13  13  13  13
13  9  11  10  18  19  20  21  21  21  21  78  81  74  75  74  144  144  144  144  144  150  149  148  44  13  13  13  13  13  13  13  13  13  13  13  13  13  13  13  13  13  13
13  9  11  10  11  11  12  13  13  13  73  77  82  75  74  75  144  144  144  144  144  144  144  144  44  13  13  13  13  13  13  13  13  13  13  13  13  13  13  13  13  13  13
13  9  11  10  11  11  12  13  13  13  72  74  75  74  76  66  186  187  188  144  144  145  146  147  45  46  46  46  46  46  47  13  13  13  13  13  13  13  13  13  13  13  13
13  9  11  10  11  11  12  13  13  13  71  70  69  68  67  65  139  140  141  144  144  125  124  123  102  101  100  99  99  99  48  13  13  13  13  13  13  13  13  13  13  13  13
13  9  11  10  11  11  12  13  13  13  13  13  13  13  13  64  138  143  142  93  93  118  117  116  103  107  108  109  98  98  49  13  13  13  13  13  13  13  13  13  13  13  13
13  9  11  10  11  11  12  13  13  13  13  13  13  13  13  64  133  134  135  93  93  119  122  115  104  106  110  111  112  97  50  13  13  13  13  13  13  13  13  13  13  13  13
13  9  11  10  11  11  12  13  13  13  13  13  13  13  13  64  132  137  136  93  93  120  121  114  105  92  92  92  113  96  51  13  13  13  13  13  13  13  13  13  13  13  13
13  9  11  10  11  11  12  13  13  13  13  13  13  13  13  64  131  130  93  93  93  93  93  93  93  92  92  92  94  95  52  13  13  13  13  13  13  13  13  13  13  13  13
13  9  11  10  11  11  12  13  12  13  13  13  13  13  13  64  126  127  127  127  127  128  129  58  57  56  56  56  55  54  53  13  13  13  13  13  13  13  13  13  13  13  13
13  9  11  10  11  11  12  13  13  13  13  13  13  13  13  63  62  62  62  62  62  62  61  60  59  13  13  13  13  13  13  13  13  13  13  13  13  13  13  13  13  13  13
13  9  11  10  11  11  12  13  13  13  13  13  13  13  13  13  13  13  13  13  13  13  13  13  13  13  13  13  13  13  13  13  13  13  13  13  13  13  13  13  13  13  13
13  9  11  10  11  11  12  13  13  13  13  13  13  13  13  13  13  13  13  13  13  13  13  13  13  13  13  13  13  13  13  13  13  13  13  13  13  13  13  13  13  13  13
13  9  11  10  11  11  12  13  13  13  13  13  13  13  13  13  13  13  13  13  13  13  13  13  13  13  13  13  13  13  13  13  13  13  13  13  13  13  13  13  13  13  13
13  9  11  10  11  11  12  13  13  13  13  13  13  13  13  13  13  13  13  13  13  13  13  13  13  13  13  13  13  13  13  13  13  13  13  13  13  13  13  13  13  13  13
13  9  11  10  11  11  12  13  13  13  13  13  13  13  13  13  13  13  13  13  13  13  13  13  13  13  13  13  13  13  13  13  13  13  13  13  13  13  13  13  13  13  13
13  9  11  10  11  11  12  13  13  13  13  13  13  13  13  13  13  13  13  13  13  13  13  13  13  13  13  13  13  13  13  13  13  13  13  13  13  13  13  13  13  13  13
13  9  11  10  11  11  12  13  13  13  13  13  13  13  13  13  13  13  13  13  13  13  13  13  13  13  13  13  13  13  13  13  13  13  13  13  13  13  13  13  13  13  13
13  9  11  10  11  11  12  13  13  13  13  13  13  13  13  13  13  13  13  13  13  13  13  13  13  13  13  13  13  13  13  13  13  13  13  13  13  13  13  13  13  13  13
13  9  11  10  11  11  12  13  13  13  13  13  13  13  13  13  13  13  13  13  13  13  13  13  13  13  13  13  13  13  13  13  13  13  13  13  13  13  13  13  13  13  13
13  9  11  10  11  11  12  13  13  13  13  13  13  13  13  13  13  13  13  13  13  13  13  13  13  13  13  13  13  13  13  13  13  13  13  13  13  13  13  13  13  13  13
13  9  11  10  11  11  12  13  13  13  13  13  13  13  13  13  13  13  13  13  13  13  13  13  13  13  13  13  13  13  13  13  13  13  13  13  13  13  13  13  13  13  13
13  9  11  10  11  11  12  13  13  13  13  13  13  13  13  13  13  13  13  13  13  13  13  13  13  13  13  13  13  13  13  13  13  13  13  13  13  13  13  13  13  13  13
13  9  11  10  11  11  12  13  13  13  13  13  13  13  13  13  13  13  13  13  13  13  13  13  13  13  13  13  13  13  13  13  13  13  13  13  13  13  13  13  13  13  13
13  9  11  10  11  11  12  13  13  13  13  13  13  13  13  13  13  13  13  13  13  13  13  13  13  13  13  13  13  13  13  13  13  13  13  13  13  13  13  13  13  13  13
13  9  11  10  11  11  12  13  13  13  13  13  13  13  13  13  13  13  13  13  13  13  13  13  13  13  13  13  13  13  13  13  13  13  13  13  13  13  13  13  13  13  13
13  9  11  10  11  11  12  13  13  13  13  13  13  13  13  13  13  13  13  13  13  13  13  13  13  13  13  13  13  13  13  13  13  13  13  13  13  13  13  13  13  13  13
13  9  11  10  11  11  12  13  13  13  13  13  13  13  13  13  13  13  13  13  13  13  13  13  13  13  13  13  13  13  13  13  13  13  13  13  13  13  13  13  13  13  13
13  9  11  10  11  11  12  13  13  13  13  13  13  13  13  13  13  13  13  13  13  13  13  13  13  13  13  13  13  13  13  13  13  13  13  13  13  13  13  13  13  13  13
13  9  11  10  11  11  12  13  13  13  13  13  13  13  13  13  13  13  13  13  13  13  13  13  13  13  13  13  13  13  13  13  13  13  13  13  13  13  13  13  13  13  13
13  9  11  10  11  11  12  13  13  13  13  13  13  13  13  13  13  13  13  13  13  13  13  13  13  13  13  13  13  13  13  13  13  13  13  13  13  13  13  13  13  13  13
13  9  11  10  11  11  12  13  13  13  13  13  13  13  13  13  13  13  13  13  13  13  13  13  13  13  13  13  13  13  13  13  13  13  13  13  13  13  13  13  13  13  13
