189  190  191  190  190  192  193  193  193  193  193  193  193  193  193  193  193  193  193  193  193  193  193  193  193  193  193  193  193  193  193  193  193  193  193  193  193  193  193  193  193  193  193
189  190  191  190  190  192  193  193  193  193  193  193  193  193  193  193  193  193  193  193  193  193  193  193  193  193  193  193  193  193  193  193  193  193  193  193  193  193  193  193  193  193  193
189  190  191  190  190  192  193  193  193  193  193  193  193  193  193  193  193  193  193  193  193  193  193  193  194  195  195  195  195  195  195  195  195  196  193  193  193  193  193  193  193  193  193
189  190  191  190  190  192  193  193  193  193  193  193  193  193  193  193  193  193  193  193  193  193  193  193  197  198  199  200  198  198  201  202  198  203  193  193  193  193  193  193  193  193  193
189  190  191  190  190  192  204  205  205  205  205  205  205  205  205  205  205  205  206  193  193  193  193  193  197  207  208  209  198  198  210  211  212  203  193  193  193  193  193  193  193  193  193
189  190  191  190  190  192  213  214  215  216  214  214  214  214  214  217  218  214  219  193  193  193  193  193  197  220  221  222  223  224  225  226  227  203  193  193  193  193  193  193  193  193  193
189  190  191  190  190  192  197  198  228  229  230  231  232  233  234  235  236  198  203  193  193  193  193  193  197  237  238  239  240  241  242  243  244  203  193  193  193  193  193  193  193  193  193
189  190  191  190  190  192  197  245  246  247  248  249  250  251  252  253  236  198  254  193  193  193  193  193  255  256  257  258  259  260  261  262  263  203  193  193  193  193  193  193  193  193  193
189  190  191  190  190  192  197  264  265  266  267  268  269  270  271  272  273  274  275  276  276  276  276  276  277  278  278  279  280  281  282  278  278  203  193  193  193  193  193  193  193  193  193
189  190  191  190  190  192  197  283  284  285  286  287  288  289  290  291  292  293  294  295  295  295  295  295  296  278  278  297  298  299  300  278  278  203  193  193  193  193  193  193  193  193  193
189  190  191  190  190  192  197  301  302  303  304  305  306  307  308  309  310  311  294  295  295  295  312  313  314  278  278  315  316  316  317  278  278  203  193  193  193  193  193  193  193  193  193
189  190  191  190  190  192  197  278  278  278  278  278  278  278  278  278  278  278  318  319  295  295  320  321  322  278  278  278  278  278  278  278  278  203  193  193  193  193  193  193  193  193  193
189  190  191  190  190  192  197  278  278  278  278  278  323  324  325  278  278  278  326  327  328  329  330  331  332  278  278  278  278  278  278  278  278  203  193  193  193  193  193  193  193  193  193
189  190  191  190  190  192  197  333  334  278  278  335  336  337  338  278  278  278  278  339  340  341  342  343  344  278  278  278  278  278  278  278  278  203  193  193  193  193  193  193  193  193  193
189  190  191  190  190  192  197  345  346  347  278  348  349  350  351  278  278  278  278  278  352  353  278  278  278  278  278  278  278  278  278  278  278  203  193  193  193  193  193  193  193  193  193
189  190  191  190  190  192  197  354  355  356  278  278  278  278  278  278  278  278  278  278  278  278  278  278  278  278  278  278  278  278  278  278  278  203  193  193  193  193  193  193  193  193  193
189  190  191  190  190  192  357  358  358  358  358  359  360  361  362  363  364  365  366  367  368  368  369  370  365  366  371  372  373  373  373  373  373  374  193  193  193  193  193  193  193  193  193
189  190  191  190  190  192  193  193  193  193  193  375  376  377  378  379  380  381  382  383  384  384  385  386  387  388  389  390  193  193  193  193  193  193  193  193  193  193  193  193  193  193  193
189  190  191  190  190  192  193  193  193  193  193  391  198  392  393  394  395  396  397  398  399  399  400  401  198  402  403  390  193  193  193  193  193  193  193  193  193  193  193  193  193  193  193
189  190  191  190  190  192  193  193  193  193  193  375  404  405  406  407  408  409  410  411  412  412  400  413  198  414  415  390  193  193  193  193  193  193  193  193  193  193  193  193  193  193  193
189  190  191  190  190  192  193  193  193  193  193  391  416  417  418  419  420  421  422  423  424  424  425  426  427  428  429  430  431  432  431  431  431  433  431  431  434  435  193  193  193  193  193
189  190  191  190  190  192  193  193  193  193  193  375  436  437  438  439  440  441  442  443  444  444  445  442  446  447  448  449  450  451  452  453  454  455  456  457  295  390  193  193  193  193  193
189  190  191  190  190  192  193  193  193  193  193  375  442  458  459  460  461  462  463  464  465  466  467  442  442  442  442  468  469  470  471  472  473  474  475  476  477  390  193  193  193  193  193
189  190  191  190  190  192  193  193  193  193  193  391  442  478  479  480  481  481  482  483  484  442  442  442  442  442  442  485  486  486  487  488  486  489  490  491  492  390  193  193  193  193  193
189  190  191  493  494  495  193  193  193  193  193  375  442  496  497  498  499  500  501  502  503  442  442  442  442  442  442  504  505  506  507  508  509  510  511  512  513  390  193  193  193  193  193
189  190  191  514  515  516  193  193  193  193  193  391  442  496  517  518  519  520  521  522  523  442  442  442  442  442  442  524  525  526  527  528  529  530  531  532  533  390  193  193  193  193  193
189  190  191  534  535  536  193  193  193  193  193  375  442  496  537  538  539  540  541  542  543  442  442  442  442  442  442  544  545  546  547  546  547  546  547  546  547  390  193  193  193  193  193
189  190  191  548  549  550  551  552  552  552  552  553  442  554  555  556  556  556  556  556  557  442  442  442  442  442  442  547  546  547  546  558  559  560  561  562  546  390  193  193  193  193  193
189  190  191  563  564  565  566  567  567  567  567  568  442  442  442  442  442  442  442  442  442  442  442  442  442  442  442  546  547  546  547  569  570  571  572  573  547  390  193  193  193  193  193
189  190  191  574  575  576  193  193  193  193  193  391  442  442  442  442  442  442  442  442  442  442  442  442  442  442  442  577  358  358  358  358  358  358  358  358  358  578  193  193  193  193  193
189  190  191  190  190  192  193  193  193  193  193  391  442  442  442  442  442  442  442  442  442  442  442  442  442  442  442  390  193  193  193  193  193  193  193  193  193  193  193  193  193  193  193
189  190  191  190  190  192  193  193  193  193  193  579  358  358  358  358  358  358  358  358  358  358  358  358  358  358  358  578  193  193  193  193  193  193  193  193  193  193  193  193  193  193  193
189  190  191  190  190  192  193  193  193  193  193  193  193  193  193  193  193  193  193  193  193  193  193  193  193  193  193  193  193  193  193  193  193  193  193  193  193  193  193  193  193  193  193
189  190  191  190  190  192  193  193  193  193  193  193  193  193  193  193  193  193  193  193  193  193  193  193  193  193  193  193  193  193  193  193  193  193  193  193  193  193  193  193  193  193  193
189  190  191  190  190  192  193  193  193  193  193  193  193  193  193  193  193  193  193  193  193  193  193  193  193  193  193  193  193  193  193  193  193  193  193  193  193  193  193  193  193  193  193
189  190  191  190  190  192  193  193  193  193  193  193  193  193  193  193  193  193  193  193  193  193  193  193  193  193  193  193  193  193  193  193  193  193  193  193  193  193  193  193  193  193  193
189  190  191  190  190  192  193  193  193  193  193  193  193  193  193  193  193  193  193  193  193  193  193  193  193  193  193  193  193  193  193  193  193  193  193  193  193  193  193  193  193  193  193
189  190  191  190  190  192  193  193  193  193  193  193  193  193  193  193  193  193  193  193  193  193  193  193  193  193  193  193  193  193  193  193  193  193  193  193  193  193  193  193  193  193  193
189  190  191  190  190  192  193  193  193  193  193  193  193  193  193  193  193  193  193  193  193  193  193  193  193  193  193  193  193  193  193  193  193  193  193  193  193  193  193  193  193  193  193
189  190  191  190  190  192  193  193  193  193  193  193  193  193  193  193  193  193  193  193  193  193  193  193  193  193  193  193  193  193  193  193  193  193  193  193  193  193  193  193  193  193  193
189  190  191  190  190  192  193  193  193  193  193  193  193  193  193  193  193  193  193  193  193  193  193  193  193  193  193  193  193  193  193  193  193  193  193  193  193  193  193  193  193  193  193
189  190  191  190  190  192  193  193  193  193  193  193  193  193  193  193  193  193  193  193  193  193  193  193  193  193  193  193  193  193  193  193  193  193  193  193  193  193  193  193  193  193  193
189  190  191  190  190  192  193  193  193  193  193  193  193  193  193  193  193  193  193  193  193  193  193  193  193  193  193  193  193  193  193  193  193  193  193  193  193  193  193  193  193  193  193
