 10  11  10  10  12  13  13  13  13  13  13  13  13  13  13  13  13  13  13  13  13  13  13  13  14  15  15  15  15  15  15  15  15  16  13  13  13  13  13  13  13  13  17  17
 10  11  10  10  12  13  13  13  13  13  13  13  13  13  13  13  13  13  13  13  13  13  13  13  18  19  20  21  19  19  22  23  19  24  13  13  13  13  13  13  13  13  17  17
 10  11  10  10  12  25  26  26  26  26  26  26  26  26  26  26  26  27  13  13  13  13  13  13  18  28  29  30  19  19  31  32  33  24  13  13  13  13  13  13  13  13  17  17
 10  11  10  10  12  34  35  36  37  35  35  35  35  35  38  39  35  40  13  13  13  13  13  13  18  41  42  43  44  45  46  47  48  24  13  13  13  13  13  13  13  13  17  17
 10  11  10  10  12  18  19  49  50  51  52  53  54  55  56  57  19  24  13  13  13  13  13  13  18  58  59  60  61  62  63  64  65  24  13  13  13  13  13  13  13  13  17  17
 10  11  10  10  12  18  66  67  68  69  70  71  72  73  74  57  19  75  13  13  13  13  13  13  76  77  78  79  80  81  82  83  84  24  13  13  13  13  13  13  13  13  17  17
 10  11  10  10  12  18  85  86  87  88  89  90  91  92  93  94  95  96  97  97  97  97  97  97  98  99  99  100  101  102  103  99  99  24  13  13  13  13  13  13  13  13  17  17
 10  11  10  10  12  18  104  105  106  107  108  109  110  111  112  113  114  115  116  116  116  116  116  116  117  99  99  118  119  120  121  99  99  24  13  13  13  13  13  13  13  13  17  17
 10  11  10  10  12  18  122  123  124  125  126  127  128  129  130  131  132  115  116  116  116  116  133  134  135  99  99  136  137  137  138  99  99  24  13  13  13  13  13  13  13  13  17  17
 10  11  10  10  12  18  99  99  99  99  99  99  99  99  99  99  99  139  116  140  116  116  141  142  143  99  99  99  99  99  99  99  99  24  13  13  13  13  13  13  13  13  17  17
 10  11  10  10  12  18  99  99  99  99  99  144  145  146  99  99  99  147  148  149  150  151  152  153  154  99  99  99  99  99  99  99  99  24  13  13  13  13  13  13  13  13  17  17
 10  11  10  10  12  18  155  156  99  99  157  158  159  160  99  99  99  99  99  161  162  163  164  165  166  99  99  99  99  99  99  99  99  24  13  13  13  13  13  13  13  13  17  17
 10  11  10  10  12  18  167  168  169  99  170  171  172  173  99  99  99  99  99  99  174  175  99  99  99  99  99  99  99  99  99  99  99  24  13  13  13  13  13  13  13  13  17  17
 10  11  10  10  12  18  176  177  178  99  99  99  99  99  99  99  99  99  99  99  99  99  99  99  99  99  99  99  99  99  99  99  99  24  13  13  13  13  13  13  13  13  17  17
 10  11  10  10  12  179  180  180  180  180  181  182  183  184  185  186  187  188  189  190  191  192  192  193  185  186  187  188  189  190  194  195  196  197  13  13  13  13  13  13  13  13  17  17
 10  11  10  10  12  13  13  13  13  13  198  199  200  201  202  203  204  205  206  207  208  209  209  210  211  212  213  205  214  215  216  217  13  13  13  13  13  13  13  13  13  13  17  17
 10  11  10  10  12  13  13  13  13  13  218  19  19  219  220  221  222  19  223  224  225  226  226  227  228  19  19  19  19  229  230  217  13  13  13  13  13  13  13  13  13  13  17  17
 10  11  10  10  12  13  13  13  13  13  198  231  232  233  234  235  236  237  238  239  240  241  241  227  242  19  243  237  19  244  245  217  13  13  13  13  13  13  13  13  13  13  17  17
 10  11  10  10  12  13  13  13  13  13  218  246  247  248  249  250  251  252  253  254  255  256  256  257  258  259  260  252  261  262  263  264  265  266  265  265  265  267  265  265  268  269  17  17
 10  11  10  10  12  13  13  13  13  13  198  270  271  272  273  274  275  276  277  277  278  279  279  280  277  277  277  281  282  283  284  285  286  287  288  289  290  291  292  293  116  217  17  17
 10  11  10  10  12  13  13  13  13  13  198  277  277  277  277  277  277  277  277  277  294  295  295  296  277  277  297  298  299  277  277  300  301  302  303  304  305  306  307  308  309  217  17  17
 10  11  10  10  12  13  13  13  13  13  218  277  277  310  311  312  313  314  311  315  316  277  277  277  277  317  318  319  320  321  277  322  323  323  324  325  323  326  327  328  329  217  17  17
 10  11  330  331  332  13  13  13  13  13  198  277  277  333  334  335  336  337  338  339  340  277  277  277  341  342  343  344  345  346  277  347  348  349  350  351  352  353  354  355  356  217  17  17
 10  11  357  358  359  13  13  13  13  13  218  277  277  360  361  362  363  364  365  366  367  277  277  277  368  369  370  371  372  373  277  374  375  376  377  378  379  380  381  382  383  217  17  17
 10  11  384  385  386  13  13  13  13  13  198  277  277  387  388  389  390  391  392  393  394  277  277  277  277  277  395  396  397  277  277  398  399  400  401  400  401  400  401  400  401  217  17  17
 10  11  402  403  404  405  406  406  406  406  407  277  277  408  409  409  409  409  409  410  411  277  277  277  277  277  277  277  277  277  277  401  400  401  400  412  413  414  415  416  400  217  17  17
 10  11  417  418  419  420  421  421  421  421  422  277  277  277  277  277  277  277  277  277  277  277  277  277  277  277  277  277  277  277  277  400  401  400  401  423  424  425  426  427  401  217  17  17
 10  11  428  429  430  13  13  13  13  13  218  277  277  277  277  277  277  277  277  277  277  277  277  277  277  277  277  277  277  277  277  431  180  180  180  180  180  180  180  180  180  432  17  17
 10  11  10  10  12  13  13  13  13  13  218  277  277  277  277  277  277  277  277  277  277  277  277  277  277  277  277  277  277  277  277  217  13  13  13  13  13  13  13  13  13  13  17  17
 10  11  10  10  12  13  13  13  13  13  433  180  180  180  180  180  180  180  180  180  180  180  180  180  180  180  180  180  180  180  180  432  13  13  13  13  13  13  13  13  13  13  17  17
 10  11  10  10  12  13  13  13  13  13  13  13  13  13  13  13  13  13  13  13  13  13  13  13  13  13  13  13  13  13  13  13  13  13  13  13  13  13  13  13  13  13  17  17
 10  11  10  10  12  13  13  13  13  13  13  13  13  13  13  13  13  13  13  13  13  13  13  13  13  13  13  13  13  13  13  13  13  13  13  13  13  13  13  13  13  13  17 434
